###############
#.............#
#...#####.....#
#.............#
#.............#
#......###....#
#.............#
#.............#
#....####.....#
#.............#
#.............#
#......###....#
#.............#
#.............#
#...#####.....#
#.............#
#.............#
#......###....#
#.............#
###############