###############
#......#......#
#.......#.....#
#....#####....#
#.............#
#.............#
#.............#
#....#####....#
#....#........#
#....#........#
#....#........#
#....####.....#
#.............#
#.............#
#.........#...#
#.....#####...#
#.....#.......#
#.....#.......#
#.............#
###############